##################################################
#           ####  ##          # #       ##########
# ####  # #   #  ##  ### ## ##  # # # #        ###
# ### #  # # ## #   # ## ####   # # ##### ## #####
# ##    #  # #  ## ## #   ##  #  #    ##  ##    ##
# # ###  #         #   # # ##  #   ## ###### ##  #
# #     #  ## # # # ## #      #  ##  # ###   ### #
#  # ##  #  # ##     #  # ##   #  # #   ###### A #
# ###  # # # #  ## ##  # #   # # #   # # # #### ##
#    #         #     # #  # #     # #         ####
### ##############################################
#                                                #
#   ###  ####   ####  ###  ###   ## ###    ###   #
#  ##   ##  ## ##    ##      ##  ##   ##  ## ##  #
#  ##   #####   ###  ## B    ##  ##   ##  ## ##  #
#  ##   ##        ## ##     ##   ##  ##   ## ##  #
#   ### ##     ####   ###  ####  ## ####   ###   #
#                                                #
#                                                #
##################################################
